Astrophysical Journal = ApJ
Physical Chemistry Chemical Physics = PCCP
Physical Review = PhRv
Journal of Chemical Physics = JChPh
Journal of the American Chemical Society = JAChS
Annual Reviews of Physical Chemistry = ARPC
International Journal of Quantum Chemistry = IJQC
Chemical Physics Letters = CPL
Astronomy and Astrophysics = A&A
Astrophysical Journal Letters = ApJL
Monthly Notices of the Royal Astronomical Society = MNRAS
The Astrophysical Journal Supplement Series = ApJS
Astrophysical Journal Supplement Series = ApJS
Annual Review of Astronomy and Astrophysics = ARA&A
The Astronomical Journal = AJ
Astronomical Journal = AJ
Astronomiceskij Zhurnal = AZh
Astronomy and Astrophysics Review = A&AR
The Astronomy and Astrophysics Review = A&AR
Astronomy and Astrophysics Supplement Series = A&As
Astrofizica = Afz
Astrophysics and Space Science = Ap&SS
Bulletin of the American Astronomical Society = BAAS
Journal of Astronomy and Astrophysics = JA&A
Nature = Nat
Publications of the Astronomical Society of Japan = PASJ
Publications of the Astronomical Society of the Pacific = PASP
Quarterly Journal of the Royal Astronomical Society = QJRAS
Science = Sci
Soviet Astronomy = SvA
Publications of the Astronomical Society of the Pacific Conference Proceedings = PASPC
Accounts of Chemical Research = AcChR
ACS Earth and Space Chemistry = ESC
Acta Physica et Chemica = AcPhC
Advances in Chemical Physics = AdChP
Advances in Quantum Chemistry = AdQC
Angewandte Chemie = AngCh
Annual Review of Physical Chemistry = ARPC
Atmospheric Chemistry and Physics = ACP
Atmospheric Chemistry and Physics Discussions = ACPD
Australian Journal of Chemistry = AJCh
Chemical Communications = ChCom
Chemical Physics = CP
Chemical Reviews = ChRV
Earth and Space Science = E&SS
Frontiers in Chemistry = FrCh
Journal of Atmospheric Chemistry = JAtC
Journal of Computational Chemistry = JCoCh
Journal of Physical Chemistry A = JPCA
Journal of Physical Chemistry = JPhCh
Journal of Physical Chemistry B = JPCB
Nature Chemistry = NatCh
Nature Astronomy = NatAs
Nature Communications = NatCo
Nature Physics = NatPh
Nature Physical Science = NPhS
Nature Reviews Physics = NatRP
Computational Astrophysics and Cosmology = ComAC
Journal of Computational Physics = JCoPh
International Journal of Mass Spectrometry and Ion Processes = IJMSI
Mitteilungen der Astronomischen Gesellschaft = MitAG
Science Advances = SciA
Journal of Molecular Structure = JMoSt
Journal of Modern Physics = JMPh
Modern Physics = ModPh
Reviews of Modern Physics = RvMP
Proceedings of the National Academy of Sciences of the United States of America = PNAS
Proceedings of the National Academy of Sciences = PNAS
Proceedings of the National Academy of Science = PNAS
Frontiers in Astronomy and Space Sciences = FrASS
Frontiers in Earth Science = FrEaS
Frontiers in Physics = FrP
Frontiers in Space Technologies = FrST
